0000000000000000000000000000000000000000000000000000000000000000000000000000000000000000000000000000
0000000000000000000000000000000000000000000000000000000000000000000000000000000000000000000000000000
0000000000000000000000000000000000000000000000000000000000000000000000000000000000000000000000000000
0000000000000000000000000000000000000000000000000000000000000000000000000000000000000000000000000000
0000000000000000000000000000000000000000000000000000000000000000000000000000000000000000000000000000
0000000000000000000000000000000000000000000000000000000000000000000000000000000000000000000000000000
0000000000000000000000000000000000000000000000000000000000000000000000000000000000000000000000000000
0000000000000000000000000000000000000000000000000000000000000000000000000000000000000000000000000000
0000000000000000000000000000000000000000000000000000000000000000000000000000000000000000000000000000
0000000000000000000000000000000000000000000000000000000000000000000000000000000000000000000000000000
0000000000000000000000000000000000000000000000000000000000000000000000000000000000000000000000000000
0000000000000000000000000000000000000000000000000000000000000000000000000000000000000000000000000000
0000000000000000000000000000000000000000000000000000000000000000000000000000000000000000000000000000
00000000000000001111111111111111111p1100000000000000000000000000000000000000000000000000000000000000
000000000000000011111111111s11111111110111111e11p110000000000000000000000000000000000000000000000000
0000000000000000110000000111100000001101111111111110000000000000000000000000000000000000000000000000
00000000000000001100000001111000000011010011001100100000000000p0100000000011111000000000000000000000
0000000000000000110000000111100000001101001100110010000000000011111111111111s11000000000000000000000
0000000000000000111111111111111111111101111111111110000000000010010010010011111000000000000000000000
000000000000000011111111111111111e111101001100110010000000000011011011011011111000000000000000000000
0000000000000000111111110111101111111101001100110010000000000011011011011011011000000000000000000000
0000000000000000110000000111100000001101111111111110000000000011111111111111011000001110011111100000
000000000000000011000000011110000000110100110011001000000000001111111e111111001000001111111111110000
0000000000000000111011011111111111111101001100110010111111p11011111111111111011000001110111101110000
0000000000000000111s1111111111111111110111111111111011100000001001001001001101p000001000111100010000
00000000000000001111111101111000000011010011001100101e1000000011011011011011011000001100011000110000
0000000000000000110011000111100000001101001100110010111000000011011011011011011000001101111110110000
0000000000000000110011000111100000001101111111111110111111111011111111111111111000001111111111110000
000000000000000011p011011111111111111100000011000000011000000000000000000001100000001111111111110000
000000000000000011111111111111111e1111000000110000000s1000000000000000000001100000001110111101110000
0000000000000000111111110111101111111100000011000000011000000000000000000001100000001000111100010000
0000000000000000110011000111101111111101111111111111111110101111110p10000111110100101100011000110000
00000000000000001100110001111011111111011111s1111111111111111111111111111111111111101101111110110000
00000000000000001110110111111111111111111111111111111111111111111111e1111111111111111111111111110000
00000000000000001111111111111111111111s1111111111111111111111111111111111111111111111111111111110000
000000000000000011111e11111111111111111111111111111111111111111111111111111111s111111111111111110000
000000000000000011111111111111111111110111111111111111s111111111111111111111111111101111111111110000
0000000000000000000000000000000000000001111111111111111111111111111111111111111111101111111111110000
0000000000000000000000000000000000000001111111000000000000000000111110000000000000001111111111110000
0000000000000000000000000000000000000001111111000000000000000000111110000000000000001010001011110000
0000000000000000000000000000000000000001111111011111111111111000111110111111111111101010001011110000
0000000000000000000000000000000000000001111111011110000011111111111111111111e11111101110001111110000
0000000000000000000000000000000000000001111111011110000011111111111111111111111111101110001111110000
0000000000000000000000000000000000000001111111011110111011110001111110001111111111101111111111110000
0000000000000000000000000000000000000001111111011111111111110001111110001111111111100000000000000000
000000000000000000000000000000000000000111e11101111e11111111000111111000111p111111100000000000000000
0000000000000000000000000000000000000001111111011111111111110001111110001111111111111100000000000000
0000000000000000000000000011111e111111111111110111111111111111111111111111111111111s1100000000000000
00000000000000000000000000111111111111s11111110111p1111111111111111111111111111111111100000000000000
0000000000000000000000000010011001100100000000011111111111111111111111111111111111111100000000000000
000000000000000000000000001001100110010000000001111111111s110001111110001111111111111100000000000000
0000000000000000000000000011111111111100000000011111111111110001111110001111111111111100000000000000
0000000000000000000000000010011001100100000000011110000011110001111110001111111111111100000000000000
0000000000000000000000000010011001100100000000011110000011110001111110001111111111111100000000000000
00000000000000000000000000111111111111000000000111100000111111111111111111111111e1111100000000000000
0000000000000000000000000010011001100100000000011111111111111111111111111111111111111100000000000000
0000000000000000000000000010011001100100000000000000000000000000111110000000000000000000000000000000
0000000000000000000000000011111111111100000000000000000000000000111110000000000000000000000000000000
0000000000000000000000000010011001100100000000000000000000000000000000000000000000000000000000000000
00000000000000000000000000100p1001100100000000000000000000000000000000000000000000000000000000000000
0000000000000000000000000011111111111100000000000000000000000000000000000000000000000000000000000000
0000000000000000000000000000000000000000000000000000000000000000000000000000000000000000000000000000
0000000000000000000000000000000000000000000000000000000000000000000000000000000000000000000000000000
0000000000000000000000000000000000000000000000000000000000000000000000000000000000000000000000000000
0000000000000000000000000000000000000000000000000000000000000000000000000000000000000000000000000000
0000000000000000000000000000000000000000000000000000000000000000000000000000000000000000000000000000
0000000000000000000000000000000000000000000000000000000000000000000000000000000000000000000000000000
0000000000000000000000000000000000000000000000000000000000000000000000000000000000000000000000000000
0000000000000000000000000000000000000000000000000000000000000000000000000000000000000000000000000000
0000000000000000000000000000000000000000000000000000000000000000000000000000000000000000000000000000
0000000000000000000000000000000000000000000000000000000000000000000000000000000000000000000000000000
0000000000000000000000000000000000000000000000000000000000000000000000000000000000000000000000000000
0000000000000000000000000000000000000000000000000000000000000000000000000000000000000000000000000000
0000000000000000000000000000000000000000000000000000000000000000000000000000000000000000000000000000
0000000000000000000000000000000000000000000000000000000000000000000000000000000000000000000000000000
0000000000000000000000000000000000000000000000000000000000000000000000000000000000000000000000000000
0000000000000000000000000000000000000000000000000000000000000000000000000000000000000000000000000000