0000000000000000000000000000000000000000000000000000000000000000000000000000000000000000000000000000
0000000000000000000000000000000000000000000000000000000000000000000000000000000000000000000000000000
0000000000000000000000000000000000000000000000000000000000000000000000000000000000000000000000000000
0000000000000000000000000000000000000000000000000000000000000000000000000000000000000000000000000000
0000000000000000000000000000000000000000000000000000000000000000000000000000000000000000000000000000
0000000000000000000000000000000000000000000000000000000000000000000000000000000000000000000000000000
0000000000000000000000000000000000000000000000000000000000000000000000000000000000000000000000000000
0000000000000000000000000000000000000000000000000000000000000000000000000000000000000000000000000000
0000000000000000000000000000000000000000000000000000000000000000000000000000000000000000000000000000
0000000000000000000000000000000000000000000000000000000000000000000000000000000000000000000000000000
0000000000000000000000000000000000000000000000000000000000000000000000000000000000000000000000000000
0000000000000000000000000000000000000000000000000000000000000000000000000000000000000000000000000000
0000000000000000000000000000000000000000000000000000000000000000000000000000000000000000000000000000
0000000000000000111111111111111111111100000000000000000000000000000000000000000000000000000000000000
0000000000000000111111111111111111111101111111111110000000000000000000000000000000000000000000000000
0000000000000000110000000111100000001101111111111110000000000000000000000000000000000000000000000000
0000000000000000110000000111100000001101001100110010000000000010100000000011111000000000000000000000
0000000000000000110000000111100000001101001100110010000000000011111111111111111000000000000000000000
0000000000000000111111111111111111111101111111111110000000000010010010010011111000000000000000000000
0000000000000000111111111111111111111101001100110010000000000011011011011011111000000000000000000000
0000000000000000111111110111101111111101001100110010000000000011011011011011011000000000000000000000
0000000000000000110000000111100000001101111111111110000000000011111111111111011000001110011111100000
0000000000000000110000000111100000001101001100110010000000000011111111111111001000001111111111110000
0000000000000000111011011111111111111101001100110010111111111011111111111111011000001110111101110000
0000000000000000111111111111111111111101111111111110111000000010010010010011011000001000111100010000
0000000000000000111111110111100000001101001100110010111000000011011011011011011000001100011000110000
0000000000000000110011000111100000001101001100110010111000000011011011011011011000001101111110110000
0000000000000000110011000111100000001101111111111110111111111011111111111111111000001111111111110000
0000000000000000111011011111111111111100000011000000011000000000000000000001100000001111111111110000
0000000000000000111111111111111111111100000011000000011000000000000000000001100000001110111101110000
0000000000000000111111110111101111111100000011000000011000000000000000000001100000001000111100010000
0000000000000000110011000111101111111101111111111111111110101111110110000111110100101100011000110000
0000000000000000110011000111101111111101111111111111111111111111111111111111111111101101111110110000
0000000000000000111011011111111111111111111111111111111111111111111111111111111111111111111111110000
0000000000000000111111111111111111111111111111111111111111111111111111111111111111111111111111110000
0000000000000000111111111111111111111111111111111111111111111111111111111111111111111111111111110000
0000000000000000111111111111111111111101111111111111111111111111111111111111111111101111111111110000
0000000000000000000000000000000000000001111111111111111111111111111111111111111111101111111111110000
0000000000000000000000000000000000000001111111000000000000000000111110000000000000001111111111110000
0000000000000000000000000000000000000001111111000000000000000000111110000000000000001010001011110000
0000000000000000000000000000000000000001111111011111111111111000111110111111111111101010001011110000
0000000000000000000000000000000000000001111111011110000011111111111111111111111111101110001111110000
0000000000000000000000000000000000000001111111011110000011111111111111111111111111101110001111110000
0000000000000000000000000000000000000001111111011110111011110001111110001111111111101111111111110000
0000000000000000000000000000000000000001111111011111111111110001111110001111111111100000000000000000
0000000000000000000000000000000000000001111111011111111111110001111110001111111111100000000000000000
0000000000000000000000000000000000000001111111011111111111110001111110001111111111111100000000000000
0000000000000000000000000011111111111111111111011111111111111111111111111111111111111100000000000000
0000000000000000000000000011111111111111111111011111111111111111111111111111111111111100000000000000
0000000000000000000000000010011001100100000000011111111111111111111111111111111111111100000000000000
0000000000000000000000000010011001100100000000011111111111110001111110001111111111111100000000000000
0000000000000000000000000011111111111100000000011111111111110001111110001111111111111100000000000000
0000000000000000000000000010011001100100000000011110000011110001111110001111111111111100000000000000
0000000000000000000000000010011001100100000000011110000011110001111110001111111111111100000000000000
0000000000000000000000000011111111111100000000011110000011111111111111111111111111111100000000000000
0000000000000000000000000010011001100100000000011111111111111111111111111111111111111100000000000000
0000000000000000000000000010011001100100000000000000000000000000111110000000000000000000000000000000
0000000000000000000000000011111111111100000000000000000000000000111110000000000000000000000000000000
0000000000000000000000000010011001100100000000000000000000000000000000000000000000000000000000000000
0000000000000000000000000010011001100100000000000000000000000000000000000000000000000000000000000000
0000000000000000000000000011111111111100000000000000000000000000000000000000000000000000000000000000
0000000000000000000000000000000000000000000000000000000000000000000000000000000000000000000000000000
0000000000000000000000000000000000000000000000000000000000000000000000000000000000000000000000000000
0000000000000000000000000000000000000000000000000000000000000000000000000000000000000000000000000000
0000000000000000000000000000000000000000000000000000000000000000000000000000000000000000000000000000
0000000000000000000000000000000000000000000000000000000000000000000000000000000000000000000000000000
0000000000000000000000000000000000000000000000000000000000000000000000000000000000000000000000000000
0000000000000000000000000000000000000000000000000000000000000000000000000000000000000000000000000000
0000000000000000000000000000000000000000000000000000000000000000000000000000000000000000000000000000
0000000000000000000000000000000000000000000000000000000000000000000000000000000000000000000000000000
0000000000000000000000000000000000000000000000000000000000000000000000000000000000000000000000000000
0000000000000000000000000000000000000000000000000000000000000000000000000000000000000000000000000000
0000000000000000000000000000000000000000000000000000000000000000000000000000000000000000000000000000
0000000000000000000000000000000000000000000000000000000000000000000000000000000000000000000000000000
0000000000000000000000000000000000000000000000000000000000000000000000000000000000000000000000000000
0000000000000000000000000000000000000000000000000000000000000000000000000000000000000000000000000000
0000000000000000000000000000000000000000000000000000000000000000000000000000000000000000000000000000